1111111111111
1010000000001
11111100C0001
10E1110000C01
10P0000000C01
1001000C00C01
1111110011111
100E11000CC01
1000110000001
1111111111111