1111111111111
1010000000001
11111100C0001
10E1000000C01
10P00F0000C01
1000000C00C01
1111100011111
100E11000CC01
1000110000001
1111111111111